x   x   x   x   x
x   p   beggar  .   x
x   .   .   .   x
x   .   .   chest   x
x   .   .   .   x
x   x   riddler x   x
    x   .   x
    x   .   x
x   x   garbage    x    x
x   .   .   .   .   x
x   x   x   guard   x   x
x   .   .   .   .   x