x	x	x	x	x	x	x	x	x
x	.	.	.	.	.	.	.	x
x	.	.	.	x	.	.	.	x
x	.	.	p	x	g	.	.	x
x	.	x	x	x	x	x	.	x
x	.	.	.	x	.	.	.	x
x	.	.	.	x	.	.	.	x
x	.	.	.	.	.	.	.	x
x	x	x	x	x	x	x	x	x