x   x   x   x   x
x   .   g   .   x
x   x   d3   x   x
x   .   .   .   x
x   x   d2   x   x
x   .   .   .   x
x   x   d1   x   x
x   .   p   .   x
x   x   x   x   x