x   x   x   x   x
x   .   g   .   x
x   x   d-door3   x   x
x   .   .   .   x
x   x   d-door2   x   x
x   .   .   .   x
x   x   d-door1   x   x
x   .   p   .   x
x   x   x   x   x